%%%%%%%%%%%%%%%%%%%%%
%P% GGGGGGGG        %
%%%                 %
%         %    %%   %
%         %         %
%                   %
%     %             %
%     %     %%      %
%                   %
%% %%           %%  %
%                   %
%%%%%%%%%%%%%%%%%%%%%
