%%%%%%%%%%%%%%%%%%%%%
%P  GGGGGGGG        %
%                   %
%         %    %%   %
%         %         %
%                   %
%     %             %
%     %     %%      %
%                   %
%% %%           %%  %
%                   %
%%%%%%%%%%%%%%%%%%%%%
