%%%%%%%%%%%%%%%%%%%%%%%%%%%%%%%%%%%%%%
%P% GGGGGGGG                         %
%%%                                  %
%                                    %
%                                    %
%                                    %
%                                    %
%                                    %
%                                    %
%                                    %
%                                    %
%%%%%%%%%%%%%%%%%%%%%%%%%%%%%%%%%%%%%%
