%%%%%%%%%%%%%%%%%%%
%P% GGGGGGGG      %
%%%               %
%                 %
%                 %
%                 %
%%%%%%%%%%%%%%%%%%%
