%%%%%%%%%%%%%%%%%%%%%
%P  GGGGGGGG        %
%                   %
%          %%%%%%   %
%                   %
%    %%%%%%%        %
%     %             %
%     %        %%%%%%
%              %    %
%%%%% %%%%%%%%%%    %
%                   %
%%%%%%%%%%%%%%%%%%%%%
