%%%%%%%%%%%%%%%%%%%%%
%P% GGGGGGGG        %
%%%                 %
%          %%%%%%   %
%                   %
%    %%%%%%%        %
%     %             %
%     %        %%%%%%
%              %    %
%%%%% %%%%%%%%%%    %
%                   %
%%%%%%%%%%%%%%%%%%%%%
