%%%%%%%%%%%%%%%%%%%
%P% G             %
%%%               %
%                 %
%                 %
%                 %
%%%%%%%%%%%%%%%%%%%
