%%%%%%%%%%%%%%%%%
%.   .         .%
%      .        %
% % %%%%%      .%
% P    G%.      %
%.      %       %
%       %.     .%
%%%%%%%%%%%%%%%%%
