%%%%%%%%%%%%%%%%%%
%        %      G%
%        %       %
%        %       %
%        %       %
%P       %      G%
%%%%%%%%%%%%%%%%%%
