%%%%%%%%%
%.   .  % 
% .     %  
% % %%%%%       
% P    G%
% .     %
%       %
%%%%%%%%%
