%%%%%%%%%
%     . % 
%    . .%  
%%.. %%%%       
% P     %
%       %
%      G%
%%%%%%%%%
