%%%%%%%%%
%.P.    % 
% %.% %%%  
%G    %%% 
%%%%%%%%%
