%%%%%%%%%%%%%%%%%%%
% .           ....%
%.% % %%%%%% %.%%.%
%.%o% %   o% %.o%.%
%.%%%.%  %%% %..%.%
%.....  P    %..% %
%%%%%%%%%%%%%%%%%%%
