%%%%%%%%
%P     %
% .% . %
%  %   %
% .% . %
%      %
%%%%%%%%
