%%%%%%%%%
%.P     % 
% %.% %%%  
%     %%% 
%%%%%%%%%
