%%%%%%%
%   . %
%..   %
%     %
%  P. %
%    .%
%%%%%P%
%%%%%%%
%    .%
%. .  %
% .  .%
%.    %
%...  %
%%%%%%%