%%%%%%%
%   . %
%.. P %
%    P%
%  P. %
%    .%
%%%%%P%
%%%%%%%
%    .%
%. .  %
% .  .%
%.    %
%...  %
%%%%%%%
%%%%%%%
%  . .%
%  ...%
%  .. %
%    .%
%.    %
%%%%%%%
%%%%%%%
%   . %
%. .  %
%.  . %
%     %
%     %
%%%%%%%
%%%%%%%
%     %
%.   .%
%...  %
%  .. %
%  . .%
%%%%%%%