%%%%%%%
%   . %
%..   %
%     %
%  P. %
%    .%
%%%%%%%