%%%%%%%%
%   P  %
% %%%%%%
%....  %
%%%%%%%%
