%%%%%%%%%%%%%%%%%
%    .         .%
%  G   .        %
%   %%%%%      .%
%P      %.      %
%.      %       %
%       %.     .%
%%%%%%%%%%%%%%%%%
