%%%%%%%%%
%     . % 
%    . .%  
%%..G%%%%       
% P     %
%       %
%       %
%%%%%%%%%
