%%%%%%%%%%%%%%%%
% %%         %%%
% .            %
%  .%%%        %
%    .        .%
%P     %. .G   %
%            %%%
%%%%%%%%%%%%%%%%
