%%%%%%%%%%%%%%%%%%%%
%  . %.  .  . %   .%
% %% % %%%%%%.% %% %
% %  . .        .%.%
% % %%.%%  %% %% %.%
%  .  .%G .G%   .  %
% % %% %%%%%% %% %.%
% % .  . . . ..  %.%
% %% %.%%%%%%.% %% %
%  ..%.  P    % .  %
%%%%%%%%%%%%%%%%%%%%
