%%%%%%%%%%%%%%%%%
%.   .         .%
%      .        %
% %G%%%%%      .%
% P     %.      %
%.      %       %
%       %.     .%
%%%%%%%%%%%%%%%%%
