%%%%%%
%P G %
% %.%%
%    %
%%%%%%
